wwwwwwwwwwwwwwwwwwwwwwwwww
w----x-----A-----x-------w
w--------------------x---w
wx-----------------------w
w--x------------x--------w
w-------x----------------w
w--------wwwwwwwwwwwwwwwxw
wwwwwwwww--w-------------w
w-x--------w----x--------w
w----------x-------------w
w-------------------x----w
wx----x----e-------------w
wwwwwwwwwwwwwwwwwwwwwwwwww
