wwwwwwwwwwwwwwwwwwwwwwwwww
w---w---w-A--------------w
w---w-w-w----------------w
w---w-w-w----------------w
w---w-w-ww---------------w
w-----w------------------w
www-wwwwwwwwwwwwwwwwwwwwww
w------------------------w
w------------------------w
w------------------------w
w--------wwww------------w
w--------w-e-------------w
wwwwwwwwwwwwwwwwwwwwwwwwww
